15 0 0 -718 11 1 -6 -437 1 -78 -277 1 -158 -134 1 -204 25 1 -372 370 1 -65 25 1 69 25 1 95 -281 1 170 -122 1 221 38 1 401 403 1 -271 181 1 305 210 8 739 4
17 0 0 -714 2 2 195 -315 2 32 437 2 183 437 2 355 319 2 355 88 2 208 8 2 15 -42 2 183 -155 2 48 -382 2 -132 420 2 -128 265 2 -132 101 2 -124 -38 2 -124 -210 2 -120 -378 8 727 -8
17 0 0 -710 11 3 149 458 3 355 -357 3 111 -475 3 242 -437 3 -48 -445 3 -166 -370 3 414 290 3 305 399 3 27 445 3 -99 395 3 -191 294 3 -254 168 3 -300 29 3 -300 -113 3 -263 -252 8 764 4
18 0 0 -714 11 4 313 -307 4 -44 445 4 158 403 4 321 311 4 435 155 4 477 -13 4 -225 449 4 431 -172 4 153 -403 4 -32 -449 4 -221 302 4 -221 151 4 -221 -4 4 -221 -151 4 -216 -302 4 -204 -445 8 777 4
16 0 0 -710 -6 1 -294 -345 1 361 -324 1 -320 318 1 -210 377 1 -97 415 1 29 432 1 151 419 1 260 390 1 373 344 1 470 264 1 -420 239 3 16 -84 3 72 17 3 -40 12 8 764 14
18 1 0 0 819 -2 5 -27 -8 5 -179 256 5 -174 -252 5 342 391 5 137 391 5 -19 374 5 342 0 5 141 -4 5 -170 382 5 -179 139 5 -179 -4 5 -174 -130 5 330 -370 5 132 -370 5 -27 -365 5 -170 -365 8 -710 8
17 1 3 0 773 6 6 -65 -386 6 284 -8 6 347 -386 6 166 -8 6 40 -8 6 -82 -8 6 204 -391 6 69 -386 6 -200 395 6 -200 256 6 -195 130 6 -204 0 6 -204 -122 6 -200 -244 6 -200 -378 8 -704 -8
17 1 1 0 769 -6 7 271 420 7 426 143 7 137 139 7 279 143 7 263 286 7 128 378 7 -53 378 7 -212 298 7 -317 155 7 -338 -25 7 -313 -189 7 -200 -349 7 -36 -428 7 145 -412 7 288 -332 8 -704 -4
17 1 4 0 722 2 8 -699 -8 9 137 -71 9 271 382 9 271 214 9 267 80 9 271 -80 9 19 -63 9 -103 -71 9 271 -227 9 271 -353 9 -246 361 9 -242 210 9 -237 67 9 -242 -71 9 -242 -206 9 -237 -349
19 1 5 0 13 0 1 454 508 1 4 360 1 323 332 1 -382 41 1 -424 -123 1 422 71 1 465 -126 1 104 -294 1 -82 -301 1 -190 -156 1 208 154 1 702 -114 1 225 -146 1 -11 -461 1 -293 351 1 -386 526 1 -189 149 1 -624 -85
14 1 2 0 -710 -6 8 688 -5 10 -93 -375 10 12 -370 10 130 -375 10 12 -265 10 8 -160 10 8 -60 10 4 45 10 8 155 10 8 260 10 12 365 10 130 365 10 -101 360
15 1 0 0 -714 11 8 746 0 11 -187 -315 11 -82 -319 11 32 -315 11 145 -315 11 36 -206 11 44 -88 11 44 25 11 40 147 11 44 269 11 -132 395 11 -212 302 11 254 -311 11 2 374
16 1 4 0 -714 11 8 746 0 12 -145 -302 12 -145 -193 12 -141 -88 12 -145 17 12 -145 126 12 -141 248 12 -141 361 12 -44 -63 12 48 -147 12 158 -256 12 27 34 12 120 130 12 221 227 12 330 336
14 1 3 0 -714 11 8 746 0 13 -149 -424 13 -149 -307 13 -158 -197 13 -162 -84 13 -162 38 13 -158 155 13 -166 273 13 -166 386 13 -36 386 13 86 386 13 212 391 13 372 395
19 1 5 0 -714 11 8 746 0 14 418 399 14 414 189 14 410 -8 14 410 -202 14 389 -412 14 275 -235 14 229 -50 14 162 130 14 61 311 14 -15 118 14 -86 -50 14 -128 -235 14 -237 -407 14 -254 -197 14 -254 -4 14 -246 202 14 -254 407
18 1 0 0 706 -2 8 -704 0 15 267 -281 15 271 -437 15 271 -92 15 271 59 15 271 210 15 271 378 15 116 218 15 27 71 15 -57 -105 15 -128 -265 15 -271 391 15 -263 223 15 -258 63 15 -254 -76 15 -254 -235 15 -250 -441
16 1 4 0 811 -2 1 -99 -424 1 -330 -151 1 -292 168 1 263 -315 1 338 -4 1 258 307 1 -65 424 8 -708 4 9 -254 -311 9 -330 13 9 -212 328 9 107 420 9 317 151 9 86 -428 9 321 -164
16 1 1 0 756 -6 2 -161 -365 2 -162 -228 2 -163 -98 2 -171 26 2 -171 147 2 -176 280 2 -180 401 2 -16 -368 2 142 -364 2 248 -301 2 290 -167 2 108 -4 2 -31 -0 2 228 -51 8 -695 -17
19 1 3 0 790 11 3 202 171 3 377 309 3 176 349 3 -131 355 3 -328 71 3 -270 -255 3 331 74 3 269 -241 3 21 -410 8 -708 8 11 -131 -362 11 -340 -90 11 -243 221 11 21 378 11 293 236 11 458 386 11 339 -79 11 175 -349
19 0 0 -710 -6 6 -63 104 6 -244 117 6 336 -211 6 676 297 6 672 129 6 680 -34 6 810 -223 6 541 -223 6 235 289 6 336 142 6 344 -22 6 113 -228 6 37 281 6 84 3 6 -152 -114 6 -391 -5 6 -349 272 6 -425 -232
18 2 3 0 0 -706 -15 4 243 258 4 55 31 4 120 -123 4 112 -363 4 -171 393 4 -166 146 4 -170 -102 4 -157 -381 8 729 13 12 368 373 12 152 127 12 -27 -84 12 184 -236 12 -26 -385 12 -171 275 12 -171 25 12 -157 -235
16 2 3 5 0 -714 11 5 272 -364 5 -9 -449 5 -270 -265 5 -133 -0 5 184 147 5 184 429 5 -159 436 8 746 0 13 134 -440 13 -161 -408 13 -259 -106 13 33 79 13 255 285 13 13 457 13 -284 346
15 2 4 2 0 -714 11 6 -321 -307 6 -104 -307 6 113 -307 6 344 -302 6 2 -192 6 2 35 6 -3 261 8 746 0 14 -208 -305 14 3 -304 14 230 -304 14 2 -76 14 -6 150 14 -3 365
17 2 3 1 0 -714 11 7 311 -317 7 172 378 7 316 -91 7 316 136 7 -151 368 7 -289 151 7 -304 -90 7 -296 -322 8 746 0 15 -298 -205 15 -303 26 15 -257 284 15 11 418 15 293 275 15 321 26 15 312 -201
17 2 0 2 0 -714 11 1 -368 -367 1 4 434 1 -63 300 1 -130 197 1 -190 77 1 -227 -34 1 -273 -140 1 -320 -246 8 746 0 9 88 308 9 158 197 9 215 86 9 283 -39 9 327 -136 9 379 -253 9 439 -370
21 2 3 0 0 769 2 2 14 -238 2 -46 -105 2 -98 29 2 -133 172 2 -198 283 2 -240 161 2 -268 41 2 -305 -70 2 -332 -171 2 -360 -295 8 -712 0 10 74 -100 10 106 22 10 142 169 10 213 286 10 274 173 10 307 47 10 342 -64 10 375 -168 10 407 -286
18 2 1 3 0 777 2 3 -208 -319 3 -152 -228 3 -94 -140 3 -24 -43 3 50 41 3 124 136 3 194 222 3 257 319 8 -704 -4 11 -266 325 11 286 -341 11 -195 236 11 -125 150 11 -55 66 11 72 -71 11 145 -163 11 212 -256
16 2 4 1 0 706 6 4 -216 -361 4 -145 -270 4 -59 -183 4 6 10 4 2 117 4 2 216 4 3 321 4 2 420 4 -282 -451 8 -716 0 12 315 -445 12 242 -351 12 165 -264 12 82 -184 12 3 -97
17 2 4 3 0 769 2 5 -59 315 5 328 315 5 193 311 5 71 311 5 -206 302 5 328 -302 5 193 -302 5 76 -302 5 -46 -307 5 -176 -302 8 -699 0 13 260 -168 13 176 -80 13 97 25 13 0 118 13 -109 206
20 2 2 3 0 -714 11 12 -5 -372 12 796 -21 12 699 -104 12 579 -63 12 449 46 12 287 -17 12 213 108 12 421 284 12 548 373 12 718 312 12 760 142 12 870 -160 12 870 -160 12 96 25 12 -202 182 12 -78 53 12 -142 -72 12 -216 -187 12 -131 -325
