2 0 0 -701 4 8 588 0
3 0 0 -701 4 1 819 -290 3 815 311
4 0 0 -701 4 1 819 -290 2 374 4 3 815 311
5 0 0 -701 4 1 843 -2 2 122 -18 3 457 300 4 480 -353
6 0 0 -701 4 1 726 -309 2 970 -9 3 718 279 4 379 -147 5 382 164
7 0 0 -701 4 1 587 -338 2 857 163 3 865 -124 4 593 353 5 298 155 6 294 -143
8 0 0 -701 4 1 906 -342 2 903 3 3 579 -216 4 908 328 5 575 210 6 575 0 7 235 8
9 0 0 -701 4 1 625 -359 2 924 188 3 1167 -6 4 921 -197 5 315 -197 6 626 344 7 311 189 8 25 0
10 0 0 -710 0 1 877 -6 2 795 -50 3 798 44 4 706 -97 5 710 101 6 617 -50 7 617 46 8 525 -13 9 711 4
8 0 0 -710 0 1 839 166 2 614 281 3 382 397 8 1016 4 9 824 -181 10 602 -311 11 404 -462
10 0 0 -710 0 1 411 187 2 635 269 3 878 174 4 289 -6 8 643 -4 9 892 -206 10 631 -311 11 388 -214 12 982 -7
9 0 0 0 4 5 766 -51 6 765 54 7 850 5 8 680 8 11 -852 -13 12 -765 43 13 -769 -59 14 -685 -8
11 0 0 -714 -4 3 768 -301 4 559 -200 5 1156 -383 6 984 -355 8 1156 -7 11 765 253 12 549 161 13 1155 382 14 974 323 15 436 -5
10 0 0 -714 -4 1 443 -132 2 440 -391 3 444 146 4 436 411 10 883 -535 11 899 -271 12 898 13 13 898 278 14 897 560
16 0 0 -714 -4 1 837 187 2 839 -110 3 566 -52 4 655 96 5 481 -8 6 742 48 7 741 -157 8 650 0 9 568 45 10 833 -207 11 840 90 12 742 -54 13 650 -96 14 746 144 15 835 -10
12 0 0 0 -407 1 -948 2 2 -223 -0 3 -711 3 4 -467 -1 5 -1161 1 8 7 5 9 501 -6 10 1161 -6 11 954 -2 13 247 -4 14 738 -3
11 0 0 -706 0 1 556 -288 2 860 50 3 859 -46 4 566 323 8 507 0 9 480 372 10 480 276 11 945 -2 13 469 -239 14 465 -339
13 0 0 -714 -4 1 829 191 2 831 294 3 83 -1 4 831 394 5 279 1 6 826 94 8 -14 0 9 181 3 11 828 -305 12 830 -403 14 830 -112 15 831 -207
11 0 0 17 -8 1 783 -15 2 -912 -5 3 -707 200 5 -704 -209 6 -497 -2 9 -705 -2 11 773 -212 12 784 190 14 969 -3 15 596 -6
10 0 0 -714 -4 1 552 -2 3 343 -10 4 457 -131 5 452 97 8 683 -8 9 925 99 11 1025 2 12 919 -126 14 805 1
10 0 0 -701 0 1 650 -548 2 629 567 3 -536 -555 4 -548 574 8 15 0 12 -292 -4 13 326 0 14 24 -321 15 13 294
13 0 0 21 4 1 650 -539 2 629 559 3 -536 -539 4 -548 561 5 351 -297 7 -284 -270 9 866 -538 10 852 557 11 -819 -541 12 -860 559 13 -287 273 15 346 301
9 0 0 4 0 1 734 1 2 730 -542 3 -690 11 4 1016 -1 5 -708 559 6 -711 -542 7 728 551 8 -1005 0
9 0 0 -693 -8 8 1011 -541 9 -965 540 10 669 -505 11 -554 124 12 3 -243 13 -291 -71 14 -749 320 15 344 -409
9 0 0 -706 -17 1 -935 565 2 -601 525 3 -262 427 4 587 -93 5 74 265 6 356 86 7 808 -300 8 973 -541
9 1 3 0 13 -17 1 1 -388 2 663 -517 3 -266 154 4 466 -164 5 -510 -193 6 293 153 7 -763 -535 8 11 429
12 1 3 0 8 -407 2 214 -147 3 -211 -144 4 -752 558 5 -544 181 6 495 183 8 7 -214 10 362 3 11 -386 6 12 688 555 13 -665 379 14 591 367
8 1 5 0 0 -4 1 -847 443 2 -379 -202 4 831 -437 8 414 215 9 -381 196 10 -830 -421 12 377 -180
10 1 4 0 575 4 1 -633 57 6 -635 -65 7 -772 -10 9 -701 313 10 -247 -535 12 -1085 9 13 -698 -340 14 -245 551 15 -261 -14
10 2 0 3 0 -714 -4 2 377 -273 3 -299 297 4 755 558 5 -666 555 7 749 -543 8 28 -9 11 -672 -544 13 -295 -251 14 385 299
