9 0 0 -710 4 1 989 -258 1 993 204 1 221 -319 1 222 300 3 735 -475 3 744 -13 3 753 476 8 -59 -13
14 0 0 853 4 1 141 -402 1 386 -300 1 548 -128 1 553 120 1 377 241 1 130 313 3 -124 -399 3 -349 -263 3 -504 -105 3 -499 100 3 -103 308 3 -335 222 8 33 4
14 0 0 -706 -4 3 365 -265 3 601 -365 3 848 -218 3 937 -4 3 223 -13 3 357 260 3 605 340 3 857 256 6 496 -92 6 500 80 6 714 -88 6 706 88 8 613 -4
17 0 0 -710 -4 1 -148 -38 1 -76 221 1 147 338 1 427 292 1 607 145 1 611 -130 1 483 -359 1 228 -400 1 -65 -301 3 126 -151 3 65 -9 3 152 133 3 314 139 3 421 11 3 317 -143 8 239 -8
14 0 0 -710 -4 1 464 -22 1 835 -7 1 652 -175 1 652 125 3 429 313 3 652 232 3 663 450 3 866 339 7 632 -531 7 426 -389 7 657 -297 7 886 -368 8 -22 5
14 0 0 -710 -4 4 951 342 4 980 -9 5 213 -370 5 207 -7 8 566 5 9 385 -197 9 396 164 9 756 -189 9 750 167 10 207 338 10 575 340 11 584 -365 11 975 -369
15 0 0 -697 -4 3 -358 -5 3 -269 193 3 173 211 3 364 33 3 819 -300 3 -223 -56 3 -65 41 3 557 -97 3 -69 269 3 -363 -181 3 426 -136 3 687 -242 3 185 -24 8 734 5
17 0 0 -697 -4 2 -326 -167 2 -121 -311 2 40 -452 2 213 -304 2 391 -176 3 389 180 3 192 2 3 -315 152 3 -138 6 3 36 -144 6 30 163 6 -149 300 6 -362 463 6 221 309 6 445 511 8 734 5
18 0 0 -697 -4 1 833 -197 1 451 408 1 27 8 1 896 -6 1 26 -175 1 454 -426 2 1081 -7 3 213 342 3 708 -363 3 207 -359 3 75 174 3 704 330 3 862 211 4 682 -8 8 419 5 10 -130 -1 12 231 -6
19 0 0 -697 -4 5 -35 346 5 -31 186 5 -31 2 5 -35 -171 5 -39 -360 6 -552 388 6 -388 291 6 -274 149 6 -224 -19 6 -216 -175 6 -224 -360 8 784 -7 9 179 -372 9 171 -158 9 184 6 9 196 174 9 322 296 9 503 384
17 1 0 0 937 -8 3 209 90 3 -47 86 3 79 -116 3 326 195 3 -153 178 3 79 -3 3 79 -242 8 -715 -11 9 79 426 9 419 300 9 -241 283 9 -333 18 9 -262 -238 9 74 -423 9 536 -24 9 381 -271
17 1 3 0 937 -8 3 -412 -168 3 487 -172 3 412 -21 3 336 134 3 223 315 3 126 151 3 -38 139 3 -109 328 3 -206 147 3 -311 -17 3 239 -399 3 139 -214 3 29 -13 3 -76 -214 3 -189 -403 8 -715 -11
17 1 1 0 937 -8 2 529 -4 2 529 -416 2 109 -412 2 521 407 2 101 420 2 -286 420 2 -286 21 2 -269 -395 8 -715 -11 10 344 -252 10 235 -181 10 235 -34 10 231 155 10 235 302 10 122 -34 10 353 -25
16 1 3 0 937 -8 1 164 -374 1 281 -235 1 382 -80 1 475 55 1 -17 -105 1 76 50 1 206 197 1 -55 386 1 -151 231 1 -256 92 1 -361 -63 1 80 302 1 -109 -252 1 29 -319 8 -715 -11
19 1 0 0 937 -8 1 412 -13 1 319 277 1 412 155 1 420 -155 8 -715 -11 11 -193 -214 11 -281 -59 11 -42 -46 11 197 -38 11 307 -193 11 -281 160 11 -290 382 11 -55 378 11 206 378 11 206 176 11 378 -332 11 122 -353 11 -113 -357
17 1 3 0 937 -8 3 -277 172 3 -470 307 3 -218 294 3 -336 67 3 -88 84 4 160 -231 4 17 -42 4 -113 -235 4 21 -428 4 21 -227 5 105 101 5 340 97 5 197 311 5 424 315 5 265 193 8 -715 -11
20 1 4 0 937 -8 2 189 -168 2 277 8 2 382 218 2 340 -239 2 458 -38 2 571 181 2 231 -416 2 71 -319 3 4 -126 3 -105 -71 3 206 223 3 63 239 3 80 29 3 -21 59 6 -218 88 6 -344 139 6 -286 248 6 -147 235 8 -715 -11
18 1 4 0 937 -8 1 -445 -185 1 -441 -391 1 -412 197 1 -420 403 1 -626 -332 1 -777 -189 1 -223 349 1 -76 193 3 -109 -176 3 -626 353 3 -777 176 3 -231 -319 3 -223 -4 3 -29 -4 3 -617 0 3 -848 0 8 -442 -3
18 1 4 0 983 -8 8 -913 -15 10 214 -71 10 210 88 10 -147 84 10 -147 -71 10 -315 8 10 21 185 10 428 13 10 21 -181 11 344 231 11 21 365 11 -302 223 11 -664 0 11 -298 -206 11 676 4 11 344 -214 11 25 -370
21 1 4 0 983 -8 1 420 214 1 391 -256 1 -239 239 1 -265 -231 1 -500 17 1 210 -172 1 567 -193 1 -63 143 1 -416 189 1 -433 -151 1 -76 -147 1 76 -21 1 210 130 1 571 143 1 664 0 8 -913 -15 11 806 -151 11 823 122 11 -655 -147 11 -651 155
20 2 4 3 0 -706 -13 8 864 2 11 382 202 11 382 -210 11 202 -214 11 55 -223 11 386 55 11 382 -76 11 -118 -214 11 -294 -227 11 -302 -105 11 -302 29 11 -302 164 11 -130 151 11 42 147 11 197 160 11 206 46 11 202 -50 11 46 -55 11 -118 -59
19 2 2 4 0 -706 -13 1 206 -118 1 0 -101 1 -185 -118 8 864 2 9 34 -340 9 206 -336 9 403 -147 9 -181 97 9 -71 235 9 25 361 9 139 231 9 239 101 9 -239 -269 9 302 -235 9 -269 -29 9 340 -25 9 -122 -340 9 -344 -168
18 2 1 5 0 -706 -13 1 151 290 1 269 206 1 118 97 1 -29 323 1 -273 277 1 -428 118 1 -428 -160 1 -265 -365 1 -21 -416 1 151 -340 1 277 -197 1 122 -130 1 -25 0 3 -34 -235 8 973 14 9 626 8 9 378 4
19 2 1 3 0 -706 -13 3 328 294 3 -370 147 3 281 50 3 252 -84 3 353 -223 3 193 -248 3 374 151 3 218 424 3 29 349 3 -139 416 3 -286 286 3 -365 -25 3 -286 -214 3 -84 -252 3 59 -92 6 59 -260 6 139 -416 8 973 14
22 2 4 5 0 -836 -4 8 973 14 14 -126 307 14 -298 269 14 -433 168 14 -437 -4 14 -277 46 14 -151 139 14 172 323 14 487 -46 14 340 244 14 479 113 14 340 25 14 197 139 14 17 319 14 88 134 14 -21 126 14 -84 -63 14 122 -67 14 160 -231 14 8 -391 14 -105 -235
23 2 1 2 0 -836 -4 1 -294 277 1 -252 29 1 -155 -227 1 -63 34 1 21 281 1 88 34 1 197 -206 1 290 42 1 332 269 3 206 395 3 -122 378 3 -403 382 3 -412 122 3 -407 -143 3 483 374 3 466 122 3 462 -147 3 466 -386 3 164 -378 3 -122 -382 3 -407 -382 8 973 14
23 2 1 4 0 -836 -4 1 -239 -420 1 -223 -256 1 -214 -97 1 -92 -227 1 67 -252 1 -97 -349 2 626 8 2 475 -76 2 487 97 2 311 172 2 365 17 2 294 -139 3 -218 113 3 -84 223 3 59 260 3 -239 445 3 -235 281 3 -92 357 6 -17 -76 6 4 97 6 160 0 8 973 14
20 2 2 1 0 -836 -4 6 -390 165 6 391 318 6 558 321 6 435 141 6 306 -15 6 175 -206 6 242 311 6 -209 313 6 -347 303 6 -498 301 6 -278 -21 6 -145 -211 6 8 -380 8 973 14 14 -58 152 14 106 136 14 23 50 14 -45 300 14 99 296
21 2 0 3 0 -836 -4 4 491 327 4 323 324 4 138 330 4 330 100 4 353 -77 4 202 -335 4 14 -383 4 -155 -314 4 -264 -85 4 -264 61 4 -98 327 4 -273 331 4 -463 330 8 973 14 12 -239 -215 12 334 -218 12 -537 202 12 577 222 12 -162 187 12 218 209
23 2 3 0 0 -836 -4 1 643 -2 1 436 -368 1 58 -502 1 -405 -364 1 -572 35 1 -407 358 1 -2 513 1 332 279 1 343 14 1 244 -193 1 36 -304 1 -239 -219 1 -306 -8 1 -204 201 1 -28 270 1 103 173 1 125 39 1 19 -77 1 -89 -77 1 -113 41 3 -10 33 8 973 14
