10 0 0 -714 -4 1 -176 -2 1 -84 -65 1 5 -132 1 -75 57 2 113 58 2 101 -74 2 210 -2 2 26 107 8 15 -8
13 0 0 8 17 1 -709 32 1 -323 -363 1 395 389 1 777 11 1 -953 389 1 975 -384 3 -844 229 3 -508 -200 3 -138 -208 3 160 221 3 609 216 3 870 -191
13 0 0 -701 -8 1 41 -4 1 287 -4 1 280 -185 1 284 194 1 467 3 4 554 -88 4 565 79 4 721 145 4 717 -171 4 860 -84 4 856 72 8 717 -1
13 0 0 -17 -8 1 -506 -249 1 -242 -67 1 -714 407 1 -509 195 1 -239 62 1 -704 -433 5 217 58 5 500 181 5 746 388 5 218 -57 5 501 -244 5 741 -439
15 0 0 21 -4 1 -811 248 1 -991 4 1 -323 554 1 -605 428 1 -601 -17 1 -294 294 1 -475 155 6 202 -525 6 508 -399 6 756 -244 6 937 -17 6 659 -8 6 475 -181 6 210 -286
13 0 0 13 445 1 -71 197 1 109 197 1 244 4 1 -239 -4 1 101 -176 1 -71 -172 7 4 130 7 -323 50 7 17 -105 7 -319 -88 7 332 76 7 323 -92
14 0 0 -714 -4 1 463 -89 1 376 -52 1 369 47 1 464 98 1 547 49 1 545 -48 3 795 -104 3 714 -49 3 725 49 3 808 95 3 882 44 3 879 -51 8 629 5
15 0 0 21 -4 2 -865 50 2 403 4 2 500 76 2 -970 -8 2 -874 -80 2 -769 -17 2 500 -88 3 -370 -4 3 714 4 3 811 55 3 802 -71 3 895 4 3 -458 63 3 -458 -80
12 0 0 -714 0 2 378 -63 2 626 454 2 630 -437 2 920 63 2 916 -151 4 378 50 4 916 -50 4 626 559 4 626 -538 4 920 172 8 626 -4
13 0 0 -714 0 2 269 -8 2 554 -319 2 785 -4 2 567 252 2 1126 -391 2 1121 374 6 290 -176 6 916 -206 6 277 160 6 525 0 6 920 193 8 34 -4
15 0 0 -714 0 3 554 -218 3 756 -88 3 680 139 3 386 -80 3 454 130 7 155 -4 7 235 -273 7 563 -441 7 832 -328 7 974 -50 7 945 231 7 605 370 7 290 260 8 575 -17
13 0 0 4 4 4 -1071 -449 4 974 491 4 -945 491 5 -966 -449 5 -1050 491 5 1042 -353 6 -1029 -361 6 1075 504 6 958 -428 7 1042 407 7 1054 -458 7 -1004 399
13 0 0 4 4 2 827 -533 2 819 533 2 -769 550 2 -790 -525 3 -462 -298 3 -462 265 3 529 244 3 525 -302 4 -185 -126 4 -193 113 4 214 -105 4 210 122
13 0 0 -13 4 3 113 -210 3 340 -353 3 601 -517 4 239 84 4 428 281 4 638 466 5 -126 193 5 -361 336 5 -634 445 6 -252 -97 6 -420 -332 6 -575 -538
17 0 0 -4 0 1 773 -214 1 -794 -319 1 -680 391 1 685 239 2 788 250 2 671 -223 2 -787 362 2 -690 -347 3 815 -312 3 718 334 3 -629 296 3 -744 -222 4 710 -318 4 -635 -242 4 -739 262 4 823 348
14 0 0 -710 4 8 588 -4 9 592 -101 9 466 4 9 718 0 9 592 97 10 605 -328 10 248 -4 10 592 328 10 941 4 11 29 0 11 592 -525 11 588 554 11 1147 -4
15 0 0 -710 4 8 0 4 9 756 -80 9 676 -4 9 756 63 11 953 -13 11 861 -76 11 861 59 12 722 -361 12 386 -248 12 231 -4 12 403 197 12 722 328 12 1105 340 12 1088 -365
16 0 0 -710 4 8 668 -256 8 676 298 9 668 -365 9 559 -248 9 676 -151 9 777 -252 10 672 202 10 567 298 10 785 294 10 676 412 13 328 -239 13 941 -521 13 962 0 13 336 290 13 953 517
14 0 0 -710 4 10 706 -59 10 706 55 10 613 -8 11 668 -172 11 832 -13 11 672 155 11 496 -13 14 239 -4 14 458 -319 14 449 298 14 878 307 14 865 -336 14 1109 -17
16 0 0 -710 4 9 1000 76 9 987 -147 9 769 0 10 983 -420 10 1004 344 10 756 176 10 466 -8 10 739 -214 11 848 -525 11 281 -185 11 554 -353 11 42 -4 11 298 189 11 563 349 11 857 525
16 1 0 0 -4 357 8 4 -8 9 538 -151 9 529 134 9 953 -428 9 979 365 9 -769 -319 9 -781 281 11 769 248 11 769 -244 11 -554 143 11 -550 -151 11 -966 -475 11 -1008 428 12 -332 0 12 319 0
15 1 2 0 -714 0 8 437 -17 10 323 -71 10 323 59 10 202 0 11 441 -143 11 437 130 12 563 -223 12 580 -71 12 575 67 12 571 206 14 739 277 14 949 365 14 958 -424 14 735 -302
13 1 5 0 29 449 13 -218 -113 13 -118 172 13 176 193 13 281 -118 14 -533 -122 14 -685 197 14 -874 470 14 -374 -424 15 953 445 15 609 -113 15 416 -416 15 794 181
15 1 3 0 -458 4 8 277 0 12 -966 -357 12 -706 55 12 -382 420 12 -113 50 12 244 -344 12 693 50 12 1046 441 13 466 -197 13 861 269 13 13 -176 13 -218 286 13 -580 277 13 -853 -160
16 1 3 0 0 134 8 8 -214 10 -697 4 10 701 4 11 -525 206 11 -521 -172 11 525 -172 11 525 202 13 -214 -336 13 -223 21 13 -227 332 13 256 -344 13 256 8 13 260 344 15 4 -458 15 8 483
17 1 0 0 -718 -13 1 302 -8 8 1008 0 14 -122 -189 14 92 -269 14 315 -298 14 554 -231 14 748 -130 14 -281 -13 14 1016 223 15 844 4 15 -126 130 15 84 248 15 302 294 15 542 260 15 714 160 15 1016 -256
16 1 3 0 -701 -4 1 -47 75 2 80 79 8 13 -17 9 -3 -395 9 -326 37 9 -169 -195 9 182 -187 9 -141 334 9 -495 316 9 210 334 9 575 341 9 365 43 10 6 -161 10 -208 170 10 264 180
15 1 1 0 34 -8 11 731 113 11 853 8 11 735 -122 11 609 4 12 -550 4 12 -643 -122 12 -634 134 12 -781 130 12 -769 -130 12 -865 0 13 731 0 14 -706 0 15 -437 0 15 483 -13
16 2 0 3 0 13 -13 8 4 -202 9 907 -265 9 890 323 9 8 491 9 13 -437 9 -890 -252 9 -886 302 11 550 -391 11 -525 -391 11 -546 449 11 533 424 11 1138 0 11 -1138 0 14 -256 143 14 298 147
16 2 2 1 0 -4 504 1 -8 -424 2 -218 -277 3 -214 -84 4 -8 -4 5 210 -101 6 218 -294 7 0 -214 8 -8 147 9 -878 357 10 -563 344 11 -256 336 12 248 336 13 512 332 14 794 332 15 -4 332
