17 0 0 -710 -17 1 386 361 1 25 504 1 -332 344 1 -483 8 1 -290 -311 1 559 13 1 336 -298 1 8 -491 3 8 -307 3 8 -155 3 8 4 3 -101 134 3 -239 265 3 134 118 3 269 244 8 802 -8
18 0 0 -937 -4 1 -672 -8 1 -466 -130 1 -260 -231 1 0 -365 1 286 -269 1 563 -130 1 798 -8 1 -475 160 1 -260 260 1 8 399 1 298 273 1 571 139 3 344 0 3 13 189 3 -311 8 3 4 -189 8 1008 -4
19 0 0 991 -8 1 -634 -265 1 -454 -122 1 -193 -84 1 25 13 1 25 155 1 286 -63 1 533 -113 1 676 -256 3 -664 -59 3 -424 277 3 34 399 3 525 265 3 710 -59 3 563 -374 3 214 -458 3 -155 -445 3 -500 -403 8 -890 -13
18 0 0 -932 -4 1 181 143 1 97 13 1 -4 -134 1 -97 8 1 -193 143 3 475 -223 3 613 0 3 483 155 3 269 273 3 269 -336 3 -8 -370 3 -286 -340 3 -512 -223 3 -617 -4 3 -483 151 3 -286 265 8 924 -8
17 0 0 -932 -4 1 -113 -340 1 -143 -172 1 -172 -4 1 -235 202 1 -281 403 1 -76 416 1 227 416 1 445 416 3 416 -311 3 328 -143 3 218 113 3 71 323 3 -101 97 3 -260 -189 3 -349 -344 8 924 -8
20 0 0 995 8 1 -4 -311 1 -202 -42 1 -202 189 1 -8 407 1 -290 344 1 -496 147 1 -491 -118 1 -458 -336 1 -193 -437 3 88 -441 3 227 -202 3 260 109 3 46 265 3 307 361 3 584 227 3 596 4 3 529 -189 3 336 -328 8 -861 -13
18 0 0 995 8 1 429 -190 1 637 -7 1 422 145 1 190 333 1 -11 495 1 -177 326 1 24 144 1 229 -49 3 -340 161 3 -468 -16 3 -251 -187 3 -117 -1 4 269 -319 4 140 -500 4 -54 -348 4 106 -169 8 -861 -13
18 0 0 995 8 3 81 263 3 248 478 3 -127 152 3 -441 178 3 464 246 3 638 38 3 805 -183 3 910 -412 3 595 -316 3 239 -172 3 -25 -48 3 -187 -228 3 -330 -395 3 -483 -187 3 -603 17 3 -718 206 8 -861 -13
21 0 0 -756 4 1 -411 -337 1 -123 -503 1 166 -491 1 457 -308 1 557 -25 1 462 248 1 158 467 1 -169 475 1 -447 245 1 -543 -32 3 226 94 3 -178 328 3 -40 184 3 84 -176 3 45 -405 3 329 285 3 60 -5 3 -132 -94 3 -370 -140 8 890 4
22 0 0 -756 4 2 411 417 2 166 489 2 -70 498 2 -311 419 2 -259 -279 2 -153 -182 2 -286 133 2 -125 40 2 -5 151 2 -5 299 2 148 209 2 283 114 2 143 31 2 -10 -34 2 143 -228 2 263 -316 2 134 -399 2 -19 -168 2 -19 -307 2 -19 -464 8 890 4
19 0 0 -756 4 6 -300 317 6 376 359 6 -296 -7 6 107 367 6 569 170 6 611 -129 6 384 31 6 174 144 6 191 -53 6 153 -288 6 15 -481 6 -94 -301 6 -107 -40 6 -111 161 6 -27 350 6 -452 119 6 -481 -141 8 890 4
19 0 0 878 -8 1 628 14 1 351 -95 1 57 -192 1 -237 -255 1 -557 -322 1 -422 -150 1 -309 2 1 -422 140 1 -552 359 1 -246 287 1 69 195 1 355 115 3 -57 2 3 -178 -3 3 90 2 3 -52 111 3 -57 -95 8 -701 4
19 0 0 878 -8 5 -229 -435 5 -431 -204 5 -468 35 5 -388 296 5 -204 514 5 300 518 5 44 497 5 489 317 5 603 48 5 569 -208 5 376 -427 5 95 -498 6 132 -204 6 -40 -145 6 -208 -204 6 -73 -301 6 61 -313 8 -701 4
19 0 0 878 -8 3 -225 -343 3 -409 -150 3 -422 128 3 -325 367 3 -132 493 3 145 489 3 368 443 3 527 283 3 103 -301 3 351 -326 3 468 -221 3 334 -91 3 389 119 6 267 -524 6 167 -419 6 -27 -390 6 83 -511 8 -701 4
20 0 0 878 -8 2 658 392 2 36 -272 2 456 350 2 658 26 2 629 -360 2 -455 -251 2 456 22 2 318 -79 2 314 144 2 288 324 2 45 362 2 -228 371 2 -468 358 2 -493 161 2 288 -247 2 456 -314 2 -195 -276 2 -497 -24 8 -701 4
20 1 0 0 979 8 1 721 26 1 637 299 1 305 425 1 53 345 1 -81 169 1 645 -230 1 469 -381 1 183 -390 1 -115 -70 3 -665 -70 3 -468 404 3 -627 198 3 -165 446 3 150 198 3 162 -66 3 11 -264 3 -203 -377 3 -493 -306 8 -949 -21
21 1 4 0 979 8 8 -949 -21 10 444 -482 10 116 -163 10 -56 -108 10 -186 -205 10 -396 -301 10 -312 -96 10 -190 60 10 -115 194 10 -316 291 10 -682 291 10 -447 442 10 -48 450 10 209 366 10 435 215 10 675 85 10 687 -58 10 540 -7 10 536 -243 10 309 -331
25 1 5 0 -853 -13 1 608 350 1 343 194 1 -274 190 1 -560 358 1 511 14 1 448 249 1 213 392 1 -157 387 1 -396 249 1 -501 -16 1 477 -255 1 536 -444 1 259 -318 1 -10 -318 1 -258 -306 1 -447 -205 1 -480 -406 3 146 -318 3 284 -188 3 427 -96 4 217 -20 4 -1 85 4 -195 -16 8 903 0
20 1 5 0 -853 -13 5 557 459 5 360 312 5 154 240 5 -31 198 5 -203 177 5 -413 165 5 553 -474 5 364 -306 5 150 -230 5 -52 -159 5 -220 -163 5 -413 -159 5 553 1 5 356 5 5 167 5 5 -35 5 5 -224 1 5 -409 1 8 903 0
22 1 0 0 -853 -13 2 368 -163 2 188 -54 2 -27 51 2 -220 -83 2 -413 -201 2 -388 -427 2 -224 -297 2 356 -377 2 175 -255 2 -27 -129 3 402 232 3 200 341 3 381 60 3 196 161 3 -22 253 3 -237 182 3 -409 35 3 -31 438 3 -245 320 3 -430 211 8 903 0
25 2 0 3 0 -853 -13 8 903 0 9 62 39 9 -48 43 9 196 -7 9 276 -188 9 87 -129 9 116 -306 9 -60 -138 9 -111 -301 9 -190 -7 9 -291 -184 11 -568 -184 11 -421 -41 11 -312 148 11 -392 -339 11 -161 -453 11 141 -453 11 372 -348 11 561 -159 11 356 -45 11 305 148 11 301 345 11 15 345 11 -291 345
23 2 1 4 0 878 17 2 -199 -322 2 -300 -175 2 -358 -49 2 -421 85 2 -371 211 2 -266 303 2 -195 152 2 -119 -12 2 -35 -175 2 49 -293 3 -14 354 3 129 316 3 246 245 3 351 106 3 435 -45 3 511 -205 3 15 207 3 204 -108 3 112 51 3 297 -243 3 -127 303 8 -869 -13
19 2 2 5 0 -722 8 3 62 -238 3 150 -117 3 91 -20 3 -48 9 3 -127 -112 3 -56 -276 3 108 -381 8 895 0 11 482 236 11 574 47 11 276 -423 11 -69 -444 11 259 446 11 -52 471 11 -300 282 11 -417 51 11 -371 -226 11 486 -243
23 2 2 1 0 -722 8 1 511 -37 1 347 173 1 272 -100 1 200 89 1 20 -159 1 20 60 1 -232 -133 1 -358 127 1 -459 -58 1 -174 85 8 895 0 9 95 232 9 -106 224 9 251 358 9 62 425 9 -119 417 9 -262 308 9 -564 -234 9 -291 -331 9 24 -377 9 347 -318 9 620 -222
25 2 5 4 0 -928 8 4 805 72 4 792 -112 4 599 228 4 591 -264 4 389 156 4 364 -188 4 225 56 4 217 -100 4 74 -7 4 -81 68 4 -106 -83 4 -245 173 4 -287 -201 4 -514 232 4 -518 -243 4 -686 85 4 -690 -91 8 987 0 9 633 81 9 620 -96 9 482 -3 9 -295 -7 9 -434 64 9 -442 -91
18 2 2 3 0 -928 8 3 -123 312 3 -577 -205 3 -526 -322 3 -354 -318 3 -178 -318 3 36 -322 3 74 -201 3 -245 -196 3 -253 -28 3 -253 156 3 -258 299 3 -388 312 8 987 0 10 -505 64 10 -39 60 10 276 64 10 616 64
23 2 1 3 0 -928 8 5 272 -255 5 272 -91 5 267 123 5 272 287 5 410 198 5 528 51 5 431 -117 6 95 119 6 -132 215 6 -295 123 6 -266 -133 6 -77 -226 6 95 -159 6 108 329 6 -81 387 6 -325 350 6 -468 173 6 -476 -163 6 -329 -343 6 -115 -398 6 120 -314 8 987 0
23 2 4 0 0 -928 8 2 440 -448 2 238 -390 2 108 -230 2 490 -310 2 351 -196 2 188 -138 2 280 9 2 456 64 2 536 194 2 599 350 2 532 450 2 372 404 2 209 240 2 162 119 2 -6 93 2 -132 173 2 -274 266 2 -426 173 2 -300 39 2 -73 -20 2 95 -33 8 987 0
25 2 2 0 0 -928 8 1 743 -176 1 491 -181 1 239 -176 1 143 -311 1 8 -433 1 -685 -168 1 -449 -168 1 -214 -176 1 -118 -311 2 647 -4 2 374 -4 2 13 -4 2 -332 -4 2 -580 8 3 731 151 3 479 151 3 223 164 3 147 302 3 17 454 3 -109 294 3 -214 168 3 -454 164 3 -680 155 8 987 0
23 2 3 4 0 -928 8 1 1012 332 1 861 340 1 714 340 1 727 139 1 727 -84 1 722 -307 1 -550 -67 1 -428 -164 1 -550 -302 1 -739 365 1 -735 155 1 -739 -50 1 -739 -302 3 -155 -218 3 -319 -0 3 -130 202 3 42 -21 3 407 -214 3 235 -8 3 433 206 3 580 -34 8 987 0
