15 0 0 -244 8 1 134 202 1 -4 336 1 -126 -197 1 -4 4 1 13 -332 3 13 -475 3 319 -323 3 496 13 3 0 470 3 -487 25 3 -353 -294 3 353 353 3 -319 344 8 294 4
16 0 0 13 483 1 -252 -260 1 -214 344 1 -752 -4 1 -260 -475 1 55 -349 1 512 164 1 538 -357 3 -470 -349 3 848 -25 3 248 344 3 286 -235 3 294 -470 3 -475 164 3 -38 -349 8 4 25
20 0 0 -710 -23 2 -899 234 2 -1050 435 2 -357 452 2 -521 238 2 -701 -258 2 727 -132 2 -596 -10 2 -815 -6 2 739 91 6 -706 87 6 840 -6 6 626 -6 6 529 192 6 718 -262 6 -706 -123 6 1037 456 6 386 435 6 928 225 8 731 -14
19 0 0 -517 15 1 -869 74 1 -785 -81 1 -664 -207 1 -508 -275 1 -361 -195 1 -252 -69 1 -181 74 3 134 284 3 25 355 3 -84 288 8 630 3 9 458 -258 9 651 -292 9 819 -199 9 903 -94 9 970 74 9 328 -115 9 231 70
18 0 0 -168 7 1 -706 -90 2 -550 -111 2 -699 140 2 -703 311 2 -848 -107 2 -781 49 2 -622 45 2 -706 -220 8 206 11 9 714 -73 10 714 154 10 638 53 10 567 -115 10 785 49 10 861 -115 10 710 -212 10 714 289
16 0 0 -4 477 3 -57 -381 3 -221 -271 3 -289 -112 3 -218 76 3 -72 243 3 205 377 3 397 446 8 -8 -69 11 53 -385 11 194 -263 11 280 -104 11 199 90 11 56 241 11 -211 388 11 -412 451
15 0 0 827 0 4 -777 50 4 340 -4 4 -248 0 4 -773 -59 4 -533 -67 4 -542 42 8 -659 -8 12 336 -399 12 -886 -4 12 -651 -105 12 -647 101 12 -437 0 12 42 8 12 328 370
18 0 0 -701 8 3 59 -17 5 -1033 13 5 1096 17 5 -731 -395 5 -424 -172 5 -147 235 5 290 231 5 542 -193 5 853 -395 8 777 0 13 -886 -202 13 -571 -378 13 -256 34 13 42 370 13 370 63 13 643 -374 13 1008 -231
17 0 0 21 -8 1 538 155 3 -592 172 6 -378 -210 6 -563 -59 6 -794 126 6 -840 281 6 -752 353 6 -525 336 6 -269 -424 14 273 -412 14 386 -231 14 512 -92 14 710 122 14 706 265 14 630 340 14 420 286
17 0 0 -937 449 7 -731 349 7 332 -449 7 428 -328 7 -185 46 7 -483 210 8 168 -206 15 -97 -101 15 21 -428 15 176 -458 15 412 -160 15 223 34 15 21 34 15 -588 46 15 -332 374 15 357 -21 15 -80 -290
17 0 0 -714 8 1 529 -185 1 937 -512 1 735 -315 1 252 -76 1 0 0 1 -281 122 1 -533 235 1 -710 353 1 -874 533 8 890 -4 12 -307 349 12 -84 269 12 -92 458 12 420 -391 12 197 -508 12 193 -260
17 0 0 21 -21 4 580 475 4 -454 437 4 886 -193 4 -374 -273 4 -508 -428 4 -718 -403 4 -756 -172 8 -949 -172 14 -269 231 14 437 265 14 403 71 14 672 -42 14 160 97 14 -214 92 14 -466 -67 14 -605 -248
17 0 0 0 -395 3 -718 8 3 525 281 3 -848 256 3 -735 466 3 -470 483 3 -336 256 3 -491 4 9 496 8 9 273 176 9 273 420 9 521 517 9 760 412 9 756 160 9 -588 269 15 -223 -151 15 214 -164
17 0 0 8 -4 2 -991 458 2 -777 298 2 -571 189 2 1008 -433 2 827 -302 2 630 -164 3 832 -4 3 -777 -4 8 -357 0 8 399 -4 15 617 176 15 811 319 15 1004 445 15 -575 -197 15 -777 -349 15 -983 -500
16 0 0 0 399 4 -626 -8 4 -781 92 4 -819 -8 4 -651 97 4 -722 -88 6 668 -92 6 588 -4 6 773 -13 6 630 101 6 731 101 11 29 -109 11 -84 -21 11 122 -13 11 -38 92 11 76 101
14 1 1 0 17 428 1 260 -76 1 361 -76 1 466 -80 4 -449 -97 4 -340 -88 4 -235 -92 12 -151 -365 12 -38 -365 12 80 -361 12 193 -361 15 -88 181 15 21 176 15 126 181
14 1 0 0 17 428 1 -164 294 1 189 302 1 -487 -63 1 483 -55 1 -55 -260 1 80 -256 3 -294 84 3 290 84 3 -210 -164 3 223 -155 3 -290 -420 3 269 -420 8 13 0
15 1 3 0 -8 -416 2 -928 -407 2 -634 311 2 -210 231 2 374 -399 2 214 244 2 680 269 2 920 -420 5 -802 -101 5 -449 542 5 8 -101 5 416 550 5 819 -76 15 -466 4 15 454 0
14 1 5 0 -706 -4 1 344 4 1 449 -76 1 454 63 1 538 0 7 651 105 7 769 59 7 878 109 7 773 172 8 664 -17 15 659 -126 15 777 -67 15 760 -210 15 882 -139
16 1 4 0 311 0 3 -559 -239 3 -344 -391 3 -101 -286 3 17 -126 3 130 -290 3 315 -395 3 567 -277 3 605 21 3 441 231 3 235 407 3 8 504 3 -601 25 3 -433 231 3 -227 382 8 -290 4
18 2 0 3 0 -714 13 4 -712 -352 4 638 -320 6 -1024 -60 6 -927 210 6 -701 357 6 -442 191 6 -345 -58 6 -256 -362 6 -1103 -336 8 651 -8 15 221 -337 15 281 -55 15 401 241 15 651 421 15 886 231 15 1035 -61 15 1076 -341
16 2 2 1 0 -269 8 1 690 6 2 692 -328 3 688 213 4 684 113 5 683 316 6 684 -107 7 690 -211 8 154 13 9 -705 24 10 -709 339 11 -697 -321 12 -707 131 13 -707 -88 14 -699 -209 15 -711 242
14 2 2 4 0 -269 8 1 -1121 491 1 1090 -482 1 753 556 1 -670 -535 3 -1082 385 3 -1022 472 3 987 -469 3 1053 -376 3 -365 559 3 446 -529 5 -1156 -6 5 1151 3 8 24 9
16 2 3 5 0 -1155 0 3 -576 4 3 -718 217 3 -716 -236 3 -423 -320 3 -179 -244 3 -439 300 3 -192 213 3 305 -15 8 -321 0 9 -9 -131 9 -9 100 9 304 -246 9 615 -412 9 292 221 9 615 345
16 2 3 4 0 -626 13 2 -898 -42 2 -706 -275 2 -425 -233 2 -303 1 2 -525 255 2 -855 201 2 -85 7 8 666 5 13 398 3 13 518 -252 13 804 -284 13 948 -25 13 867 229 13 536 222 13 159 8
16 2 2 5 0 -714 -4 1 837 191 2 839 -114 3 566 -52 4 655 96 5 481 -8 6 268 107 7 741 -157 8 -22 0 9 568 45 10 833 -211 11 840 90 12 268 -113 13 650 -96 14 746 144 15 839 -10
16 2 4 5 0 4 -395 1 180 154 2 98 109 3 100 204 4 8 63 5 13 260 6 -80 109 7 -80 206 8 -172 147 9 14 164 10 -404 323 11 19 503 12 420 362 13 -563 -114 14 16 -142 15 619 -123
17 2 0 1 0 -202 -101 1 -17 386 1 571 449 1 -13 50 1 365 378 1 172 -403 1 328 -206 1 315 46 1 172 239 3 -349 34 3 -353 -223 3 -197 -399 3 -38 -227 3 -197 231 3 -651 437 3 -428 353 8 176 -101
18 2 3 1 0 -416 151 1 -718 -302 1 -517 -281 1 -441 -134 1 449 -139 1 550 -311 1 764 -323 1 882 -126 1 -844 -143 8 458 172 11 -647 -105 11 680 -134 11 13 416 11 84 168 11 -29 164 11 -126 -71 11 25 -71 11 176 -67
16 2 4 1 0 932 -13 1 643 -386 3 -697 -155 3 -693 -50 3 -697 67 3 -701 172 3 -617 -101 3 -605 8 3 -605 113 3 -525 -50 3 -521 67 3 -437 4 4 -244 -4 5 630 4 6 626 340 8 -987 -8
