16 0 0 -714 -8 1 1050 -491 1 811 -449 1 630 -311 1 588 -97 1 848 -105 1 1025 -239 1 567 71 1 622 294 1 819 475 1 836 113 1 1029 269 1 1071 496 3 844 -277 3 819 302 8 361 -8
18 0 0 -714 -8 3 214 -525 3 428 -538 3 269 -50 3 609 -202 3 88 -370 3 596 -424 3 118 -197 5 920 164 5 916 374 5 777 508 5 538 521 5 403 374 5 403 172 5 764 25 8 517 -4 9 374 -311 9 680 315
20 0 0 -714 -8 7 714 -391 7 979 -542 7 974 -84 7 974 -235 7 970 -386 7 714 -235 7 714 -80 7 445 -214 7 441 -84 8 25 0 15 974 80 15 970 218 15 718 76 15 714 227 15 718 365 15 449 59 15 445 206 15 445 378 15 449 529
18 0 0 -714 -8 4 609 -185 4 794 4 4 445 0 4 622 193 8 622 0 12 735 370 12 496 370 12 260 365 12 248 122 12 248 -118 12 945 374 12 949 130 12 949 -105 12 937 -328 12 735 -336 12 466 -328 12 248 -328
18 0 0 -714 -8 2 560 531 2 749 367 2 909 186 2 871 -158 2 753 -368 2 640 -528 2 321 304 2 447 148 2 443 -200 2 329 -360 8 181 13 10 959 -3 10 833 6 10 711 -3 10 573 -3 10 438 1 10 317 1
16 0 0 962 4 5 -481 279 5 -234 384 5 44 434 5 329 371 5 585 279 6 52 182 6 48 -246 8 42 -17 13 -473 -251 13 -263 -398 13 39 -494 13 317 -427 13 552 -251 14 279 -20 14 -175 -28
16 0 0 689 17 4 -628 6 5 -977 1 5 -834 -129 5 -620 -230 5 -309 22 5 363 22 5 -175 -125 5 207 -158 5 485 -141 5 695 -246 5 993 22 5 -406 -125 5 18 -246 5 880 -137 8 21 13
19 0 0 777 4 1 14 -7 4 178 -7 4 27 -288 4 157 -154 4 107 169 4 -196 371 4 -402 413 4 -158 -381 4 -368 -452 8 -697 8 12 -116 148 12 -19 295 12 174 367 12 367 426 12 -145 -11 12 -103 -171 12 350 -440 12 186 -389
20 0 0 655 0 5 -750 -238 5 -746 -20 5 -528 -402 5 -301 -171 5 682 -431 5 -57 -104 5 216 -99 5 485 -188 5 875 -251 8 -523 -7 13 -721 253 13 -523 363 13 -318 195 13 -40 186 13 262 190 13 485 232 13 699 392 13 892 203 13 896 -7
20 0 0 512 0 2 -439 220 2 -406 -230 2 -746 169 2 -612 73 2 -612 -95 2 -750 -196 2 -284 115 2 -154 -3 2 -280 -116 8 -494 -3 10 228 6 10 333 -108 10 476 -217 10 371 115 10 497 182 10 644 -141 10 825 -251 10 690 94 10 833 211
18 1 1 0 781 -8 1 123 14 1 6 140 1 -124 1 1 -3 -150 8 -704 1 11 354 -3 11 2 384 11 -364 -11 11 2 -381 12 787 -175 12 640 1 12 791 144 12 938 1 12 -708 -158 12 -847 1 12 -557 1 12 -700 157
17 1 3 0 -714 4 1 -225 400 1 388 426 1 212 262 1 -91 262 1 56 127 1 396 -41 1 153 -45 1 -61 -49 1 -267 -49 1 -11 -183 1 -66 -297 1 128 -183 1 174 -301 1 52 -402 3 52 -284 8 833 -3
20 1 0 0 -714 4 6 606 178 6 455 6 6 438 -398 6 199 -335 6 -78 -486 6 -175 -288 6 -469 -116 6 -313 64 6 -313 421 6 -95 329 6 119 510 6 249 300 8 833 -3 14 266 90 14 52 220 14 -171 111 14 279 -104 14 39 -217 14 -175 -99
20 1 2 0 -714 4 1 140 321 1 -133 316 2 396 304 2 388 81 2 -393 85 2 -389 308 3 -393 -133 3 -137 -141 3 132 -137 3 384 -141 4 -339 -444 4 342 -444 4 128 -309 4 -154 -318 6 556 405 6 724 547 6 -557 417 6 -750 526 8 833 -3
20 1 4 0 -613 -13 3 594 220 3 1014 1 3 816 1 3 753 144 3 422 148 3 312 1 3 90 1 5 594 -284 5 598 451 8 585 1 11 -112 6 11 -326 1 11 -460 178 11 -771 144 11 -859 1 11 -1057 -7 11 -620 224 13 -620 -280 13 -628 463
20 1 3 0 -714 -4 1 617 -288 1 593 279 1 -352 276 1 -363 -268 3 602 -553 3 426 -393 3 434 -188 3 585 -20 4 -540 161 4 -544 363 4 -372 539 8 863 -11 11 758 169 11 753 379 11 564 526 12 -360 -7 12 -192 -171 12 -204 -368 12 -389 -519
20 1 0 0 -714 -4 3 263 -78 3 -146 -89 6 -151 -255 6 322 -364 6 -228 -376 6 322 50 6 147 112 6 -54 113 6 -205 48 6 568 303 6 563 91 6 -452 303 6 -454 91 6 442 -77 6 61 -77 6 -338 -79 6 261 -251 6 63 -262 8 863 -11
17 1 5 0 -714 -4 8 627 6 13 430 -232 13 355 95 13 691 286 13 930 24 13 806 -254 14 597 -432 14 1047 -205 14 1003 318 14 396 371 14 197 -128 15 534 141 15 722 120 15 775 -68 15 605 -161 15 485 -36
19 1 0 0 -714 -4 3 497 196 3 283 264 3 39 264 3 -198 207 3 -343 23 3 617 23 3 505 -134 3 262 -223 3 27 -238 3 -200 -147 8 -82 -8 10 -447 -137 10 -538 -294 11 772 -106 11 775 103 11 969 -228 11 981 201 11 978 -17
18 1 0 0 -777 -4 5 360 167 5 365 23 5 370 345 5 154 367 5 -82 365 5 -292 367 5 -297 192 5 -297 15 5 548 2 5 349 -151 5 194 -288 5 -484 -4 5 -307 -151 5 -116 -271 5 34 -393 8 -322 -310 13 153 -57
16 2 3 0 0 -567 -8 1 -798 84 2 -340 -189 3 -634 269 4 -265 0 5 -584 -294 6 -378 202 7 -785 -151 8 504 -8 9 340 176 10 290 -197 11 764 76 12 752 -168 13 512 -311 14 202 4 15 588 231
19 2 5 1 0 -710 -4 6 1021 155 6 1058 -63 6 848 286 6 916 -244 6 794 -382 6 638 -504 6 454 -370 6 307 172 6 328 -202 6 479 294 6 227 -21 8 -13 0 14 428 496 14 668 353 14 647 -277 14 601 -50 14 903 504 14 693 130
20 2 2 3 0 -710 -4 3 -1 0 6 -438 -290 6 -370 -122 6 -265 88 6 -148 302 6 -1 496 6 167 311 6 285 101 6 369 -130 6 436 -290 7 209 -239 7 12 -332 7 -177 -252 7 314 -349 7 167 -433 7 8 -496 7 -139 -420 7 -291 -353 8 789 0
20 2 5 0 0 -710 -4 2 390 -189 2 62 -281 2 -211 -55 2 625 -59 2 453 -344 2 -139 -487 2 -375 -286 2 -454 -63 2 150 -504 8 58 -4 10 352 59 10 629 55 10 239 470 10 -68 462 10 -274 281 10 -454 59 10 -194 160 10 58 269 10 486 315
20 2 4 2 0 987 -17 3 764 -252 3 579 -193 3 486 -29 3 570 412 3 432 197 3 -576 420 3 142 189 3 -190 206 3 -438 164 3 -480 -76 3 -253 -181 3 45 -164 3 281 -168 3 377 -332 3 675 -428 3 491 -487 8 591 -332 11 -614 -193 11 -807 -260
21 2 4 2 0 -710 -13 2 663 92 2 457 80 2 558 -84 3 327 -151 3 549 -231 3 764 -155 3 848 42 3 780 260 3 554 323 3 323 269 3 268 46 8 554 21 11 890 357 11 969 462 11 230 357 11 113 466 11 986 -361 11 877 -269 11 146 -374 11 239 -265
22 2 2 5 0 -710 -13 2 541 76 2 680 227 2 705 403 2 579 559 3 327 155 3 192 315 3 3 386 3 -190 307 4 -131 -391 4 -76 -202 4 45 -59 4 209 8 5 335 -122 5 281 -277 5 360 -462 5 566 -529 6 541 -134 6 747 -227 6 948 -155 6 1058 4 8 411 4
22 2 0 3 0 256 -25 8 -193 -8 9 -454 59 9 -462 -80 9 -353 -21 9 -118 218 9 -252 227 9 -202 122 9 -126 -248 9 -265 -239 9 -193 -126 9 -55 -13 12 84 -13 12 399 -17 12 517 -92 12 517 55 12 260 92 12 202 189 12 332 185 12 260 -151 12 202 -256 12 336 -256
24 2 1 4 0 -1025 -4 2 1163 -386 2 986 -281 2 848 -130 2 852 67 2 990 235 2 1171 365 5 386 554 5 234 403 5 12 307 5 -219 399 5 -383 550 8 1032 0 10 -980 244 10 -1148 365 10 -849 71 10 -849 -118 10 -980 -265 10 -1143 -378 13 -362 -538 13 -244 -382 13 -9 -286 13 230 -344 13 377 -521
22 2 2 5 0 -1025 -4 1 822 -130 1 -89 0 2 41 -67 2 705 -164 3 37 63 3 818 -4 4 171 -139 4 696 176 5 814 256 5 167 -17 6 818 130 6 163 109 7 818 -256 8 705 -55 9 444 -63 10 323 -13 11 444 55 12 701 67 13 570 0 14 575 -126 15 575 126
